.................
.................
.................
.................
....##.##........
............#....
...#.F.F....#....
.....FF.....#....
...#..*P*..#.....
...#....F*.......
...#.*.F.F.......
.................
.................
.....#P..........
.....P.*#........
.................
.................
.................
.................
.................