..........
########..
.........*
####F.....
........P.
.....F....
.####.####
..........