............P.......
.F#.................
......#...........P.
...*..F.............
....................