...........
...........
...P#......
..P#P......
...P..#P...
......*P...
.P.*P.#P...
....#.F....
...........
...........
...........
...........