..........
########..
.........*
####F#..P.
........P.
.....F....
.####.####
..........