..........
########..
.........*
####F.....
........P.
..........
.#########
..........