...........
########...
......F..*P
########...
...........
...........
.##########
...........
...........
...........
...........