...........
########...
....F.F..*.
########...
........P..
...........
.##########
...........
...........
...........
...........