...........
.....F.....
.F..#P.....
...........
...........
...........
.##########
...........
...........
...........
........FFF