..............
..............
...*.###......
.#.....#......
....*.........
.......#..#...
..........#...
..*..#....#...
.F........#...
.P.###....#...
...#......#...
...#..........
..............
..F...........
.#............
.#............
.#####........
..............
..............
..............
..............