..............
......F.......
...*.###......
.#.....#......
....*.........
.......#..#...
.....F....#...
.P*..#....#...
..P.......#...
...###....#...
...#......#...
...#..........
..............
..............
.#............
.#............
.#####F.......
..............
..............
..............
..............