..........
.F........
....*.....
..F.......
..#.*.....
.P........
..........
..........
..........