.........
......F..
...*.....
..P*.....
.........
.........