...........
...........
....#......
..P#.......
......#P...
......*....
...*P.#....
....#.F....
..........F
....F......
...........
...........