......#.*..#F#.
.#..*.#.F*#...#
..#.*.P.....*..
#.......###....
....##.......#.
....F..F.P...*.
.*.*..###..*...
*......#*......
....*.##.......
......P.....*..
.......*..*#..*