......#.*..#.#.
.#..*.#.F*#...#
..#.*.......*..
#.......###....
....##.......#.
.............*.
.*.*..##...*...
*......#*......
....*.##.......
............*..
....P..*..*#..*