............
............
.......FF...
........#..P
..........##
...........#
............