............
P...........
P.......FF..
........#*..
.......F..##
...........#
............