............
............
........FF..
........#*..
.......F.P##
...........#
............