......#.*..#.#.
.#..*.#..*#...#
..#.*.......*..
#.......###....
....##.......#.
.............*.
.*.*..##...*...
*......#*......
....*.##.......
............*..
.......*..*#..*
.*.*..*.......*
....*.....#....
*.....*........
........*..*..*
...............
.#....#.#..#.#.
..#..##.#......
..#..#.....###.
*.......*......