....................
..........#......*..
..#*.........#......
..#......*..*.......
....*.....*.....*...
.#....*.........*...
.*........#*....#...
......**..FF........
...*.......#........
.............***....
....*.....*.....*...
.#....*.........*...
.*........#*....#...
......**............
...*.......#........
.......P.....***....
....*.....*.....*...
.#....*.........*...
.*........#*....#...
......**............
...*.......#........
.............***....
....................
....................
..*.................
....................
..#.................
..*.................
..*.................