............
............
........FF..
.......P#*..
.......F.P##
...........#
............