..........
..$.......
..........
....FF....
....*X....
....P.P...
..........