..F.......
...FF..F..
.#**#..*P.
...P..F...
......#...
......P...
..........