..F.......
.P*FF..F..
F#F.F..*P.
.F*P#.F...
..F#F.#...
......P...
..........