.#..F.GGG...
..F...FG*...
..**F...F.F.
...F.F.###..
.F.....#....
####...#.*F.
..#......*..
.....*......
............
..###**#..##
..#.........
..*.........
###....#....
............
..........**
.....#....#.
.##*##..**#.
............
..##.P.P*...
....P.P.P...